████████████
██P█   █   █
██ █ █ ███ █
██   █     █
██████████ █
██   █   █ E
██ █ █ █ █ █
██ █   █   █
██ █████████
██ █   █   █
██ █ █ █ █ █
██   █   █ █
