██████████
██       █
████ ███ █
██   █P█ █
██ █ █ ███
██ █ █   █
██ █████ █
██   █   E
██ █ █ ███
██ █     █
